                                                    
           ########            ########             
        #############        #############          
       ###############      ###############         
     ##################    ##################       
    ####################  ####################      
   ############################################     
  ##############################################    
  ##############################################    
  ##############################################    
  ##############################################    
   ############################################     
    ##########################################      
     ########################################       
      ######################################        
       ####################################         
         ################################           
           ############################             
            ##########################              
              ######################                
                ##################                  
                  ##############                    
                    ##########                      
                     ########                       
                       ####                         
                        ##                          
