      ###       ###       
    #######   #######     
  ########## ##########   
 #######################  
######################## 
 #######################  
  #####################   
   ###################    
    #################     
      #############       
        #########         
          #####           
            #             
