                                                                                                        
                                                                                                        
                         ###########                            ###########                             
                      #################                      #################                          
                  #######################                  #######################                      
                ###########################              ###########################                    
              ##############################            ##############################                  
             ################################          ################################                 
            ##################################        ###################################               
          #####################################      #####################################              
         #######################################    #######################################             
        ########################################    ########################################            
       ##########################################  ##########################################           
      ########################################################################################          
     ##########################################################################################         
     ##########################################################################################         
    ############################################################################################        
    ############################################################################################        
    ############################################################################################        
    ############################################################################################        
     ##########################################################################################         
     ##########################################################################################         
      ########################################################################################          
       ######################################################################################           
        ####################################################################################            
         ##################################################################################             
          ################################################################################              
           ##############################################################################               
            ############################################################################                
             ##########################################################################                 
              ########################################################################                  
                ####################################################################                    
                 ##################################################################                     
                   ##############################################################                       
                     ##########################################################                         
                      ########################################################                          
                        ####################################################                            
                          ################################################                              
                            ############################################                                
                              ########################################                                  
                                ####################################                                    
                                  ################################                                      
                                    ############################                                        
                                      ########################                                          
                                        ####################                                            
                                         ##################                                             
                                          ################                                              
                                            ############                                                
                                             ##########                                                 
                                               ######                                                   
                                                ####                                                    
                                                 ##                                                     
