####################################### ############################################################
#   #   #   # # # # # # #     #             # # #                 #                               ##
### ### ### # # # # # # ### # ####### # ##### # ### # # ##### # ### ####### # ######### # ### # # ##
# #     #         # #       #         #     #       # #     # #           # # #       # #   # # # ##
# ##### ######### # # ########### # ### ##### ### # # ### ##### # # ########### ######### ##### ####
# #         #     # # # #         # #           # # # #       # # # #   #           # # #     #   ##
# ######### ##### # ### ####### # ### # # ######### # # # ##### # ### ### ### ### ### # ##### # ####
# #       #   #   #   #         #   # # #         # # # #     # #           #   #     #     # #   ##
# ####### ### ### ### ######### # ### # # # ### # # # # ####### # # # ##### ########### ### ########
#       # #       #         #   # #   # # #   # # # # #       # # # #     #               #   #   ##
# # # # # # ##### ######### ### # ### ### ### # # ####### ####### # ### # ##################### ####
# # # #     # # #               # #   #     # # #       #       # #   # #   #                     ##
# ### # ##### # ####### ### ### # # # ### # # # # ### # ### ##### # # # # ##### ####################
#   # # #             # #     # # # # #   # # # # #   # #       # # # # #                         ##
##### # # ### ### ### ### # # # # # # ### # ######### ### # ##### # ### # ##### ### ##### ##########
#     # # #   #   #       # # # # # #   # #         #   # #     # # #   #     #   #     #         ##
### # ### ### ### # # # # # # # ### # ### # ####### # # # ### ####### # # # ### ################# ##
#   # #   #   #   # # # # # # #   # #   # #       # # # #   #       # # # #   #   #           # # ##
# # ######### ##### ### # # ### # ####### # ####### # # ### ### # # # # ### ### ### ##### # ### ####
# #   #       #     #   # # #   #       # #       # # #   #   # # # # #   #   #         # #     # ##
# # ######### ### # # # # # # # # # # ##### # # ### # # # # # # ####### ### # ####### ########### ##
# # #         #   # # # # # # # # # # #   # # #   # # # # # # #   #       # #     # #             ##
# # # # # ####### ### ### ##### ##### # ########### # ### # # # ##### # ### # # # # ### ### ### # ##
# # # # # #       #   #     #     #               # #   # # # #     # #   # # # #     # #   #   # ##
# # # # # # ##### ### # # # ### # ### ### ####### ####### # ### # # ### # ### # # ### ##### # # ####
# # # # # #   #   #   # # # #   #   # # #       #       # #   # # #   # #   # # #   #     # # #   ##
# ####### # # # # ##### ### # # # # # # # ##### ### # # ### # # # # # ### ### ### ########### ######
# #     # # # # # #       # # # # # # #     #     # # # #   # # # # # #     #   #       #   # # # ##
# # ### # ##### ### # # ### ### ##### # # ### # # ######### ### ### ####### # # # ####### ##### # ##
# # #   # #     #   # # #     #     # # #   # # # #       # # #   # #   #   # # #   #   #         ##
##### # # ####### ### ##### # ##### # ##### # # ### ######### ####### ### # ##### ### ### ##########
#     #   #       #   # #   #     # #     # # #         #           #     #     #       #   #     ##
### ### # ### # # # ### # # # ####### # # ##### ####### ### ##### ### # ### # # # ### ### ### ######
#   #   # #   # # # #     # #       # # #     #       #         #   # # #   # # #   #             ##
# ######### ### ### # ##### # # # # # # # # ### ##### ### # # ####### # # # ####### ### # # # ######
# #         #   #   # #     # # # # # # # # #     #     # # #       # # # #       #   # # # #     ##
####### # ##### ##### # # # ### # # # # # # ##### ### # # # # ### ### ### # # ##### # # ### ##### ##
#       # #     #     # # # #   # # # # # #     # #   # # # #   # # #   # # #     # # #   #     # ##
####### ### # # ##### ### ### # # # # ### # # ### ### # ####### ### ##### ##### ### ### # # ### ####
#         # # # #       #   # # # # # #   # #   #   # #     #           # #       #   # # #   #   ##
# ### # ##### # ##### ### # # ### ####### # # ### # # # ### # # # # ### ### # # # ##### # # # # ####
# #   # #     # #     #   # #   #   # #   # #   # # # # #   # # # #   # #   # # #     # # # # #   ##
# ##### ##### # # ### # # ### ### ### ### ##### ### # ### # # # # # ####### # ### # ##### ##### # ##
# #     #     # # #   # #   #   #       # #       # # #   # # # # #     #   #   # #     #     # # ##
####### ### ### # ### # # # ##### ### ####### # ######### ##### # ####### # # ### # # # # # # ### ##
#       #   #   # #   # # #     #   #       # #   # # #     #   #       # # #   # # # # # # #   # ##
### ##### # # # ### # # # # ### ### ####### # ##### # # # ### # # # ####### ##### # # # # ####### ##
#   #     # # # #   # # # #   #   #       # #         # #   # # # #   #         # # # # #     #   ##
# # ### ### ####### # # # # ################# # ##### # # # # # # ##### ### # # ### # # # # # ### ##
# # #   #     #     # # # #                 # #     # # # # # # #   #     # # #   # # # # # # #   ##
# ##### ### ##### # ### # ### # ### ####### ##### ### # ### # # ####### ### ##### ### ### # ### # ##
# #     #   # # # #   # # #   #   #       # #       # # #   # #       #   #     #   #   # #   # # ##
########### # # ### ### ##### ####### ##### # ### # ####### # # ####### ### # # # # # ##### # # # ##
#           #         # #           #     # # #   #   #     # #       #   # # # # # #     # # # # ##
################# # # # ### # # # # ### # # ##### # ### # # ########### # ##### # ##### # ### # # ##
#         # #     # # #   # # # # #   # # # #     #   # # #           # #     # #     # #   # # # ##
### ### # # ##### # ##### # # # ### # ####### ### # # # # # # ##### ####### ### # # # ##### ##### ##
#   #   # #       #     # # # #   # #       # #   # # # # # #     #       #   # # # #     #   # # ##
##### ### ### ### ####### # # # ### ### ######### ### ##### ####### ####### ### ### # # # # ### # ##
# #   #         #       # # # #   # # #     # #     # #         # #       # # # #   # # # # #     ##
# ####### # # ### # ### # # # # ##### ##### # ### ######### # ### # # ### ### ####### ########### ##
#         # #   # #   # # # # #           #   #       #     #     # #   #           #   # # #     ##
# # ##### # # ##### # ####### # # # # # # # ##### # # # # ##### ### # ####### # ### # ### # ### # ##
# # #     # #     # # #       # # # # # # #   #   # # # #     #   # #   #   # #   # #       #   # ##
# ####### # # # ### ####### # # ##### ### # # ### ### # # # ### ##### # # ### ##### # # ##### # # ##
# # #     # # #   # #       # #   #     # # # #     # # # # #       # #   # # #   # # #     # # # ##
# # # # # ### # ### ##### # # # # ####### # ### # ############# # ####### # ### # # # # # ####### ##
#   # # # #   #   # # #   # # # #       # # #   #         #     #   #   #       # # # # # #       ##
### # # # # # # # ### # # # # # # ####### # # # # # ##### ### # # # # ##### ########### # # # # # ##
# # # # # # # # # #     # # # # #       # # # # # #     #   # # # #       #           # # # # # # ##
# # ####### ####### # ### ### # ### # # # # # # # # # # # ### # # # ### ### # ### # ### # ### ### ##
#       #   #       # #     # #   # # # # # # # # # # # #   # # # #   # #   #   # # # # #   #   # ##
# # ##### # # # ### # # # # # ### # # ### # # ### ### ### # ### ### ### ############# ##### # # # ##
# #     # # # # #   # # # # #   # # #   # # #   # #     # # #   #     #                   # # # # ##
# # # ### # # ### # ### # # ####### # # ##### # # ### ##### # ### # ### # ################# # ### ##
# # #   # # # #   # #   # #       # # #   #   # # #       # # #   # # # #                 # #   # ##
# # ### # # # ### # # ### ### # # ### # ##### ### # # # ########### # # # ####### ##### ##### ### ##
# # #   # # # #   # # #     # # #   # #     #   # # # #   #   #     #   #       #     # #   # #   ##
# ### # # # ### # # ##### ### # # ### ### ### ##### # # ### ##### # ### # ### ####### ### ##########
#   # # # # #   # #   #   # # # #   #   #   #   #   # #         # # #   #   #       #   # #       ##
# ### # # # # ### # ##### # ######### ### ### # # ### ### ### ##### ### # ############### # # ### ##
#   # # # # # #   # #         #     # # #   # # # #     #   # #     #   # #                 #   # ##
### ### ### # ### ### # ### # # ####### ####### # ### # # # ### # # ### ### ##### ####### ##########
#     # # # # #   #   # #   #                 # # # # # # #   # # # #           #     # # #       ##
# # ### # # ### # ### # # # # # # # ##### ######### # # # # # # # ### # ############### ### ### # ##
# #   # #   #   # #   # # # # # # #     # #       #   # # # # # # # # #       #               # # ##
### # ### # ### # ### # # # # # # ### ##### ####### ### ##### # ### ### ####### ##### # # ### # ####
#   # # # # #   # #   # # # # # #   #             # #     #   # #                   # # #   # #   ##
# ##### # # ##### # ### # # ### # # # # # # ### ##### # # # ######### # ### ####### ##### # ########
#   #     # # #   # #   # #   # # # # # # # #     #   # # # # #       #   #   #   #     # #       ##
### ##### ### # # ### # # # ####### # # # # ##### # ### ##### ##### # # # ### # # # ##### ### # # ##
#     #   #     # #   # # #   #   # # # # #     # # #     # #       # # #   #   # #     #   # # # ##
# # ### # ### ### ### # ### # # ####### ##### ######### ### ### # ### # # # ##### # ##### # # ### ##
# # #   # #     # #   # #   #         # #       #     #     # # # #   # # #     # #     # # #   # ##
# # # # # # ##### # # # # ### # ### # # ### # ##### ### ##### # ### # ### # ####### ####### # # # ##
# # # # # #   # # # # # # #   #   # # # #   #       # #       # #   #   # #       #       # # # # ##
### # # ### # # # ##### # # ##### # # ##### # ####### # ##### ##### # # ### # # ### ################
#   # # #   # #   #     # #     # # # #     #         #     # #     # # #   # #   #               ##
################# ##################################################################################
