###############################################################################
#               #   #   #     #     #               # #         #         #   #
# # ########### # # ### # # ### ### # # ########### # # # ##### ##### ### # # #
# # #     #   # # #   #   #   # #   # #       #   #   # #   #         # # # # #
# # # ### # # # # ### # ##### # # # # ####### # # ##### ### ########### # ### #
# #   #   # # # #   # #     #   # # # #     #   #     # #   #   #         #   #
####### ### # # ### # ##### ##### # # ### # ######### # # # # # # ####### # # #
#     #   # #       # #   #   # # # #   # #         #   # # # # #   #   #   # #
# ### ### ########### ### ### # # # ### # ######### ##### ### # # ### # ##### #
# #     #   #   #   # #     # # # #   # # #             #   # # # #   #     # #
# ##### ### # # # # # # ### # # # ### # # # ########### ### # # # # ####### ###
# #   #     # # # # # #   # #   #   # # # # # #   #   #   #   # # # #     #   #
# # # ####### # ### # ### # # ##### # # ### # # # # # ### ##### ### ### # ### #
# # # #       #   # # #   # # #     # #     # # #   #         #         #   # #
# # # # ######### # # # ##### # ##### ####### # ########################### # #
#   # #   #   #   # # #       #   #       #   # #   #                 #     # #
# ### # ### # # ### # ########### ####### # ### # ### ############### # ##### #
# # # # #   #   #   #   #       #       #   #   #   # #       #     # #     # #
# # # # # ####### # ### # ##### ####### ##### ### # # ####### # # ### ####### #
#   #   #       # #   # # #   # #     #     #   # # # #     # # #             #
### ########### ### ### # # ### # ### ##### ### ### # # ### # # ############# #
# #   #       #   #   #   #   # #   #         #     # # #   # # # #   #     # #
# ### ####### ### ### ##### # # # # ######### ##### # # # ### # # # # ##### # #
#   #           #   #       #   # #       #   #   # #   # #       # #     # # #
# ############# ### ####### ####### ##### ##### # # ##### ### ##### ##### # # #
#     #       # # #       # #     #     #     # # # #   #   # #   # #     # # #
##### # ##### # # ####### # ### # ##### ##### # # # ### ### ### # # # ##### # #
#     # #     #   # #   # #   # #     #     #   #         #     # # #   #     #
# ##### # ####### # # # # ### # ##### ##################### ##### # ### ##### #
# #     #       # # # # #   #   #   #                     #   #   # # #     # #
# # ######### ### # # # ### ####### ##################### ### # ### # ##### # #
#   #     # #       # #     #       #     #     #   #     #   #           # # #
# ### ### # ######### ########### ### # ### # ### # # ##################### # #
#     #       #       #         #   # #     #     # #                 #     # #
####### ####### ########### ### # # # ############# ################# # ##### #
#       #       # #         # # # #     #           #     #         # #   #   #
######### ####### # # ####### # ######### ######### # ### # ####### # ### #####
#         # #     # # #     #   #       #       # # #   #   #     # #   # #   #
# ######### # ### # # # ### ### # ##### # ##### # # ### ##### # ### ### # # # #
# #   #     #   #   # # # #   #   # #   #   #   # #     #   # #   # # # # # # #
# # # # ##### ####### # # ### ##### # ##### # ### ####### ### ### # # # # # # #
# # # #       #     # #   # # #   #   #   # # #           #     #     # #   # #
# # # ######### ### # ### # # ### # ### # # # # # # ##### # ########### ##### #
#   # #   #   #   #     # # #   # # # # # # # # # # #   # #   #         #     #
##### # # # # # # ##### # # ### # # # # # # # ### ### # ##### # ######### ### #
#   # # #   # # #   #   #   #   #   #   #   #   #     # #   # #   #     #   # #
# # # # ##### # ### ### # ### ### ############# # ##### # # # ### # ##### # ###
# #   #     # #   #   # # #   # # #             # #     # #   #   #       #   #
# ### # ##### ##### # # # # ### # # ############# # ##### ##### ########### # #
#   # # #     #   # # # # # #   # # #   #         #           # #         # # #
### # # # ### # # ### ### # # ### # # # ######### ############# # # ##### ### #
#   # # #   # # #   # #   # #   #   # #         # #     #       # #   # # #   #
# ##### ### # # ### # # ### # # # ### ######### # # ##### ####### ### # # # ###
# #     # # # #   # #   #   # #   #   # #       # # #   # #         # # # #   #
# # ##### # # ### # ##### ######### ### # ####### # # # # ########### # # ### #
# # #     # # #   # #     #     #   #   # #       #   # #             # # #   #
# # ##### # # # ### # ### # ### # ##### # ### ####### # ############### # # ###
#         # # # # # #   # # # #   #     #   # #     # #   #     # #   #   #   #
########### ### # # ### ### # ####### # ### # # ### # # # ### # # # # # ##### #
#       #   #     #   #   # #         #   # #   # # # # #     #   # #   #     #
# ##### # ### ####### ### # ### ########### ##### # ### ######### # ##### ### #
# #     # #   #     #   # #   #   #         #           #     #   #     #   # #
# ##### # # ### ### ### # ### ### # ##### ############### # ### ####### # # # #
#     # # # # # #       #   #     #   # # #         #     #     # #   # # # # #
##### # # # # # ### ##### ### ####### # # # ####### ##### ####### # # # # # ###
#     # #     #   # #   #     #     # #   #   #   #     #       # # # # # #   #
# ##### ##### ### # # # ####### ### # ####### ### ##### ####### # # # # ##### #
#   # #     # # # # # #       # # # # #     # #       #   #   #   # # #       #
### # ##### # # # # # ####### # # # # # # ### # ##### ### # # # ### # ####### #
#   #     # # # # # #   #     # #     # #   #   #   # # # # # # #   #       #  
# ### ### # # # # ##### # ##### ##### # ### ####### # # # ### # # ##### ##### #
#   #   # # #   #     # #   #     #   # #         # #   #   # # #     #   #   #
# # ##### # ### ### ### ### ### # ##### # # ##### # ### ### # # # ####### # ###
# # #   #     #   #       #   # #     # # # #   #   # #   # #   # #       #   #
# # # # ##### ############### # ##### # # ### # ### # # ### # ### # ### ##### #
  #   #     #       #       # #   #   # #     #   #   # #   #   # # #   #   # #
# ######### ####### # ##### # ### # ### ######### ##### # ####### # ##### # # #
#           #         #       #   #             #       #         #       #   #
###############################################################################
